manipulate | manipulated | manipulation | manipulating
fake | faked
photoshop | photoshopped
edit |edited | editing
modify | modified | modifying | modification
doctored | doctoring
retouch | retouched | retouching
artificial
synthesize | synthesized | synthesizing | synthetic
false
man-made
unnatural
rumor | rumour | rumoured | rumors | rumours
unreal | unrealistic
viral | virals
lie | lying | lied | lies
hoax | hoaxes
delusion | delusions
fool | fooled
deceive | deceived | deceitful
deceptive | deception | deceptions
wile | wiled
counterfeit | counterfeiting | counterfeited
forge | forged | forgery | forging
spurious
sham
spoof
fudge | fudged
satire
parody | parodying | parodied
copy | copied | copying
tamper | tampering | tampered
funny
cheat | cheating | cheated
repost | reposting | reposted
joke | jokes | joking
fabricate | fabricated | fabricating | fabrication
dubious | dubitable
doubt | doubtful
faux
mock
mislead | misleaded | misleading
pseudo
concoct | concocting | concocted
feign | feigned | feigning
diddle | diddled | diddling